4,4,4, 4, 4, 4,4,4,4,4, 4, 4, 4, 4,4,4
4,4,4, 4, 4, 4,4,4,4,4, 4, 4, 4, 4,4,4
4,4,5, 1, 2, 3,4,4,4,4, 1, 2, 2, 3,4,4
4,4,4, 6, 7, 8,4,4,4,4, 6, 7, 7, 8,4,4
4,4,4,11,12,13,4,4,4,4, 6, 7, 7, 8,4,5
4,4,4,4, 4, 4, 4,4,4,4, 6, 7, 7, 8,4,4
4,4,4,4, 4, 4, 4,4,4,4,11,12,12,13,4,4
4,4,4, 4, 4, 4,4,4,4,4, 4, 4, 4, 4,4,4
4,4,4, 4, 4, 4,4,4,4,4, 4, 4, 4, 4,4,4
4,4,4, 4, 5, 4,4,4,4,4, 4, 5, 4, 4,4,4
4,4,4, 4, 4, 4,4,4,4,4, 4, 4, 4, 4,4,4
4,4,4, 4, 4, 4,4,4,4,4, 4, 4, 4, 4,4,4
4,4,4, 4, 4, 4,4,5,4,4, 4, 4, 4, 4,5,4
4,4,4, 5, 4, 4,4,4,4,4, 4, 4, 4, 4,4,4
4,4,4, 4, 4, 4,4,4,4,4, 5, 4, 4, 4,4,4
4,4,4, 4, 4, 4,4,4,4,4, 4, 4, 4, 4,4,4